
NO ./texture/kita.xpm
SO ./texture/minami.xpm
WE ./texture/nishi.xpm
EA ./texture/higashi.xpm

F 185,107,47
C 30,144,255

11111111111111111
10000000000000001
10000000011111001
1000000001  11001
100000E0011111001
10000000000000001
10000000000000001
10000000000000001
11111111111111111
			11111