NO ./texture/kita.xpm
SO ./texture/minami.xpm
WE ./texture/nishi.xpm
EA ./texture/higashi.xpm

F 85,107,47
C 30,144,255

11111111111111111
10000000000000001  
10000000000E00001
10000000000000001
10000000000000001
10000000N00000001
10000000000000001
10000000000000001
11111111111111111