NO ./texture/kita.xpm
SO ./texture/minami.xpm
WE ./texture/nishi.xpm
EA ./texture/higashi.xpm

F 85,107,47
C 30,144,255

11111111111111111
10000000000000001
10000000000000001
1000000000000000111111
100000N0000000001    1
10000000000000001    1
10000000000000001
10000000000000001
11111111111111111