NO ./texture/kita.xpm
SO ./texture/minami.xpm
WE ./texture/nishi.xpm
EA ./texture/higashi.xpm

F 85,107,47
C 30,144,255

1111111 111111111
1000001 100000001
1000001 100000001
10000011100000001
100000N0000000001
10000000000000001
10000000000000001
10000000000000001
11111111111111111